20 15
8 11
480 480 480 480 480 480 480 480 480 480 480 480 480 480 480 480 480 480 480 480 
480 480 480 480 480 480 480 480 480 480 480 480 480 480 480 480 480 480 480 480 
480 480 480 480 480 480 480 480 480 480 480 480 480 480 480 480 480 480 480 480 
480 480 480 480 500 503 503 503 503 503 503 503 503 503 503 506 480 480 480 480 
480 480 480 480 501 504 504 504 504 504 504 504 504 504 504 507 480 480 480 480 
480 480 480 480 502 505 505 505 505 505 505 505 505 505 505 508 480 480 480 480 
480 480 480 480 542 545 545 545 545 545 545 545 545 545 545 548 480 480 480 480 
480 480 480 480 542 540 540 540 540 540 540 540 540 540 540 547 480 480 480 480 
480 480 480 480 542 540 540 540 540 540 540 540 540 540 540 547 480 480 480 480 
480 480 480 480 542 540 540 540 540 540 540 540 540 540 540 547 480 480 480 480 
480 480 480 480 542 540 540 540 540 540 540 540 540 540 540 547 480 480 480 480 
480 480 480 480 542 540 540 540 540 540 540 540 540 540 540 547 480 480 480 480 
480 480 480 480 480 480 480 480 480 480 480 480 480 480 480 480 480 480 480 480 
480 480 480 480 480 480 480 480 480 480 480 480 480 480 480 480 480 480 480 480 
480 480 480 480 480 480 480 480 480 480 480 480 480 480 480 480 480 480 480 480 
