15 14
7 12
510 503 503 503 503 523 503 503 503 503 503 503 503 503 526 
511 514 514 514 514 514 514 514 514 514 514 514 514 514 517 
512 515 515 515 515 515 515 515 515 515 515 515 515 515 518 
542 545 545 545 545 545 545 545 545 545 545 545 545 545 548 
542 540 540 540 540 540 540 540 540 540 540 540 540 540 547 
542 540 540 540 540 540 540 540 540 540 540 540 540 540 547 
542 540 540 540 540 540 540 540 540 540 540 540 540 540 547 
520 503 503 503 503 516 540 540 540 520 503 503 503 503 526 
521 524 524 524 524 527 540 540 540 521 524 524 524 524 527 
522 525 525 525 525 528 540 540 540 522 525 525 525 525 528 
542 545 545 545 545 545 540 540 540 545 545 545 545 545 548 
542 540 540 540 540 540 540 540 540 540 540 540 540 540 547 
542 540 540 540 540 540 540 540 540 540 540 540 540 540 547 
480 480 480 480 480 480 480 480 480 480 480 480 480 480 480 
