50 20
1000 1000
4 5 4 5 4 5 4 5 4 5 4 5 4 5 4 5 4 5 4 5 4 5 4 5 4 5 4 5 4 5 4 5 4 5 4 5 4 5 4 5 4 5 4 5 4 5 4 5 4 5 
4 5 4 5 4 5 4 5 4 5 4 5 4 5 4 5 4 5 4 5 4 5 4 5 4 5 4 5 4 5 4 5 4 5 4 5 4 5 4 5 4 5 4 5 4 5 4 5 4 5 
0 0 0 4 5 10 10 10 10 10 10 10 10 10 10 10 10 10 10 10 10 10 10 10 10 10 10 10 10 10 10 10 10 10 17 10 10 10 10 10 10 10 10 10 18 10 10 10 10 14 
0 0 0 4 5 0 0 0 0 0 0 0 0 0 26 4 5 4 5 4 5 0 0 0 0 0 0 0 0 0 0 0 0 0 11 0 45 41 41 41 41 41 46 0 12 0 0 0 0 12 
0 0 0 4 5 0 0 0 0 0 0 0 0 0 0 0 0 0 0 0 0 0 0 0 0 445 441 446 0 0 0 0 0 0 11 0 43 40 52 42 51 40 44 0 12 0 0 0 0 12 
0 0 0 4 5 0 0 0 0 0 0 0 0 0 0 0 0 0 0 0 0 0 0 0 0 443 440 444 0 0 0 0 0 0 11 0 43 40 44 0 43 40 44 0 12 0 0 0 0 12 
0 0 0 0 0 0 0 0 0 0 0 0 0 0 27 0 0 0 0 0 0 445 441 441 441 452 440 451 441 441 441 441 446 0 15 10 47 42 48 0 47 42 48 10 16 0 0 0 0 12 
5 4 5 4 5 0 0 0 0 0 0 0 0 0 45 41 41 41 46 0 0 447 442 442 442 450 440 449 442 442 442 442 448 0 0 0 0 0 0 0 0 0 0 0 0 0 0 0 0 12 
4 5 4 5 0 0 0 0 0 0 0 0 0 0 43 40 40 40 44 0 0 0 0 0 0 443 440 444 0 0 0 0 0 0 0 0 0 0 0 0 0 0 0 0 0 0 0 0 0 12 
11 0 0 0 0 0 0 0 0 0 0 0 0 0 43 40 40 40 44 0 0 0 0 0 0 443 440 444 0 0 0 0 0 0 0 0 0 0 0 0 0 0 0 0 0 0 0 0 0 12 
11 0 0 0 0 0 0 0 0 0 0 0 0 0 43 40 40 40 44 0 0 0 0 0 0 443 440 444 0 0 0 0 0 0 0 0 0 0 0 0 0 0 0 0 0 0 0 0 0 12 
11 0 0 0 0 0 0 0 0 0 0 0 0 0 43 40 40 40 44 0 0 445 441 441 441 452 440 451 441 441 441 441 441 441 441 441 441 446 0 0 0 0 0 0 0 0 0 0 0 12 
11 0 0 0 0 0 0 0 0 0 0 0 0 45 49 40 40 40 44 0 0 447 442 442 442 450 440 449 442 442 442 442 442 442 442 442 442 448 0 0 0 0 0 0 0 0 0 0 0 12 
11 45 41 41 41 41 41 0 0 0 41 41 41 49 40 40 40 40 44 0 0 0 0 0 0 443 440 444 0 0 0 0 0 0 0 0 0 0 0 0 0 0 0 0 0 0 0 0 0 12 
11 43 40 40 40 40 40 0 0 0 40 40 40 40 40 40 40 40 44 60 60 60 60 64 1 443 440 444 1 0 0 0 0 0 0 0 0 0 0 0 0 0 0 0 0 0 0 0 0 12 
45 49 40 40 40 52 42 0 0 0 40 40 40 40 40 40 325 321 321 466 0 0 0 62 1 443 440 444 1 0 0 0 0 0 0 0 0 0 0 0 425 421 421 421 421 421 421 421 426 12 
49 40 40 40 40 44 0 0 0 465 321 321 326 40 40 40 323 320 320 464 0 0 0 66 1 447 442 448 1 0 0 0 0 0 0 0 0 0 0 0 423 35 31 31 31 31 31 36 424 12 
40 40 40 40 40 44 0 0 0 463 320 320 331 321 321 321 332 320 320 471 466 0 0 0 0 0 0 0 0 0 0 0 0 0 0 0 0 0 0 425 420 33 30 30 30 30 30 34 424 12 
40 40 40 40 40 44 0 0 0 463 320 320 329 322 322 322 330 320 320 460 464 0 0 64 0 0 0 0 0 0 0 0 0 0 0 0 0 0 425 420 420 33 30 30 30 30 30 34 424 12 
40 40 40 40 40 44 0 0 0 463 320 320 324 40 40 40 323 320 320 460 464 60 60 66 0 0 0 0 0 0 0 0 0 0 0 0 0 0 423 420 420 33 30 30 30 30 30 34 424 12 
