15 10
0 0
13 10 10 10 10 10 10 10 10 10 10 10 10 10 14
11 0 0 0 0 0 0 0 0 0 0 0 0 0 12
11 0 0 0 2 0 2 0 1 0 0 0 0 0 12
11 0 0 0 2 0 2 0 0 0 0 0 0 0 12
11 0 0 0 2 2 2 0 26 0 0 0 0 0 12
11 0 0 0 2 0 2 0 21 0 0 0 0 0 12
11 0 0 0 2 0 2 0 27 0 0 0 0 0 12
11 0 0 0 0 0 0 0 0 0 0 0 0 0 12
11 0 0 0 0 0 0 0 0 0 0 0 0 0 12
15 10 10 10 10 10 10 10 10 10 10 10 10 10 16